10 10
..........
..........
s...##..d.
.s..##...d
s...##..d.
.s..##...d
s.......d.
.s..##...d
..........
..........